1.2g...........g4.3
##g#############g##
...#ggg.....ggg#...
##.#g##..g..##g#.##
r#.#g#...g...#g#.#r
r#.#.....g.....#.#r
r#.#.....g.....#.#r
r#.#.ggggggggg.#.#r
r#.#.....g.....#.#r
r#.#.....g.....#.#r
r#.###...g...###.#r
.#.#r####.####r#.#.
.#.#rrr.....rrr#.#.
.#.#....###....#.#.
........#r#........
