1.2.............4.3
##.#############.##
...#ggg.....ggg#...
...#g##..g..##g#...
...#g#...g...#g#...
...#.....g.....#...
...#.....g.....#...
...g.ggggggggg.g...
...#.....g.....#...
...#.....g.....#...
...###...g...###...
...#r#########r#...
...#rrr.....rrr#...
...#....###....#...
........#r#........
